0,0,0,0,0,0,0,0,0,0,0,0,
1,0,1,0,1,0,1,0,1,0,1,0,1,
0,1,0,1,0,1,0,1,0,1,0,1,
0,1,0,1,0,1,0,1,0,1,0,1,0,
0,0,1,0,1,0,1,0,1,0,1,0,
1,0,1,0,1,0,1,0,1,0,1,0,1,
0,1,0,1,0,1,0,1,0,1,0,1,0,
0,1,0,1,0,1,0,1,0,1,0,1,0,
0,0,1,0,1,0,1,0,1,0,1,0,0
0,0,0,0,0,0,0,0,0,0,0,0,

0,0,0,0,0,0,0,0,0,0,0,0,
0,0,0,0,0,0,0,0,0,0,0,0,
3,0,0,2,0,0,2,0,0,2,0,0,3,
0,1,1,0,1,1,0,1,1,0,1,1,0,
3,0,0,2,0,0,2,0,0,2,0,0,3,
0,1,1,0,1,1,0,1,1,0,1,1,0,
3,0,0,2,0,0,2,0,0,2,0,0,3,
0,0,0,0,0,0,0,0,0,0,0,0,
0,0,0,0,0,0,0,0,0,0,0,0,
0,0,0,0,0,0,0,0,0,0,0,0,

0,0,0,0,0,0,0,0,0,0,0,0,
0,0,0,0,0,0,0,0,0,0,0,0,
2,1,0,0,1,2,2,1,1,1,1,2,
1,1,2,1,1,1,0,0,1,2,1,1,
2,1,0,0,1,2,2,1,1,1,1,2,
2,1,1,1,1,2,2,1,0,0,1,2,
1,1,2,1,0,0,1,1,1,2,1,1,
2,1,1,1,1,2,2,1,0,0,1,2,
0,0,0,0,0,0,0,0,0,0,0,0,
0,0,0,0,0,0,0,0,0,0,0,0,

0,0,0,0,0,0,0,0,0,0,0,0,0,
0,0,3,0,0,3,3,3,0,0,3,0,0,
1,0,0,0,1,0,0,0,1,0,0,0,1,
0,2,2,2,0,0,2,0,0,2,2,2,0,
0,0,0,0,0,0,0,0,0,0,0,0,0,
1,1,1,1,1,1,1,1,1,1,1,1,1,
0,0,0,0,0,0,0,0,0,0,0,0,0,
4,4,4,4,4,4,4,4,4,4,4,4,4,
0,0,0,0,0,0,0,0,0,0,0,0,0,
0,0,0,0,0,0,0,0,0,0,0,0,0,

0,0,0,0,0,0,0,0,0,0,0,0,0,
0,0,5,0,0,0,5,0,0,0,5,0,0,
0,2,0,0,0,2,0,0,0,2,0,0,0,
3,0,0,0,1,0,0,0,3,0,0,0,1,
0,0,0,2,0,0,0,2,0,0,0,2,0,
0,0,5,0,0,0,5,0,0,0,5,0,0,
0,0,0,0,0,0,0,0,0,0,0,0,0,
0,1,0,1,0,1,0,1,0,1,0,1,0,
0,0,0,0,0,0,0,0,0,0,0,0,0,
0,0,0,0,0,0,0,0,0,0,0,0,0,

0,0,0,0,0,0,0,0,0,0,0,0,0,
0,2,0,5,0,3,0,5,0,2,0,5,0,
0,0,0,0,0,0,0,0,0,0,0,0,0,
0,1,4,1,4,1,4,1,4,1,4,1,0
0,0,0,0,0,0,0,0,0,0,0,0,0,
0,2,2,0,0,3,3,3,0,0,2,2,0,
0,0,0,0,0,0,0,0,0,0,0,0,0,
0,1,1,1,1,1,1,1,1,1,1,1,0,
0,0,0,0,0,0,0,0,0,0,0,0,0,
0,0,0,0,0,0,0,0,0,0,0,0,0,

0,0,0,0,0,0,0,0,0,0,0,0,0,
0,1,1,1,1,1,1,1,1,1,1,1,1,
0,1,2,0,0,3,3,3,3,0,2,0,1,
0,1,2,0,0,0,0,3,0,0,2,0,1,
0,1,2,0,0,0,0,3,0,0,2,0,1,
0,1,2,0,0,0,3,0,0,0,2,0,1,
0,1,2,0,0,0,3,0,0,0,2,0,1,
0,1,2,2,0,3,3,3,3,0,2,2,1,
0,1,1,1,1,1,1,1,1,1,1,1,1,
0,0,0,0,0,0,0,0,0,0,0,0,0,

3,5,3,1,1,5,1,5,1,1,3,1,5,
0,0,0,0,0,0,2,0,0,0,0,0,0,
0,0,0,5,2,0,2,0,2,5,0,0,0,
0,0,0,2,5,0,2,0,5,2,0,0,0,
0,0,0,5,2,0,2,0,2,5,0,0,0,
0,0,0,2,5,0,2,0,5,2,0,0,0,
0,0,0,0,0,0,2,0,0,0,0,0,0,
0,0,0,3,3,0,2,0,3,3,0,0,0,
0,0,0,0,0,0,2,0,0,0,0,0,0,
3,5,3,1,1,5,1,5,1,1,3,1,5,

0,0,0,0,0,0,0,0,0,0,0,0,0,
0,0,0,0,0,0,0,0,0,0,0,0,0,
6,6,6,6,6,6,6,6,6,6,6,6,6,
6,2,2,2,2,6,6,6,2,2,2,2,6,
6,2,3,3,3,2,2,2,3,3,3,2,6,
6,2,3,3,2,3,3,3,2,3,3,2,6,
6,2,3,3,3,2,2,2,3,3,3,2,6,
6,6,2,2,2,6,6,6,2,2,2,6,6,
0,0,0,0,0,0,0,0,0,0,0,0,0,
0,0,0,0,0,0,0,0,0,0,0,0,0,

0,0,0,0,0,0,0,0,0,0,0,0,0,
0,0,0,0,0,0,0,0,0,0,0,0,0,
2,0,8,0,8,0,8,0,8,0,8,0,2,
0,7,0,7,2,2,2,2,2,7,0,7,0,
0,1,0,1,3,3,3,3,3,1,0,1,0,
0,1,0,1,3,3,3,3,3,1,0,1,0,
0,7,0,7,2,2,2,2,2,7,0,7,0,
2,0,3,0,3,0,3,0,3,0,3,0,2,
0,0,0,0,0,0,0,0,0,0,0,0,0,
0,0,0,0,0,0,0,0,0,0,0,0,0,





